20
6,10,10,10,11,11,11,11,11,11
11,11,11,10,11,11,11,11,11,11
11,11,11,10,10,13,10,11,11,11
11,11,11,11,11,11,10,11,11,11
11,11,11,11,11,11,10,10,14,10
11,11,11,11,11,11,11,11,11,15
